#  #####################
#            z         #
#                      #
#  #################   #
#  #   T##             #
#  #    ##             #
#  #    ##    ##   #   #
#  #M   ## Z  ##   #   #
#  #    ##    ##   #   #
#  #          ##   #   #
#  #  ##########   #   #
#  #  ##      ##  Z#   #
#  #  ##  ## T##   #   #
#  #  ##  ######   #   #
#  # Z##      ##   #   #
#  #  ######  ##   #   #
#  #  ##      ##   #   #
#  # M##  ######   #   #
#  #####           #   #
#  #T        Z     #   #
#  #################   #
#     Z                #
#                      #
######################S#
